11111111111111
11111100000001
111111000C0001
11111100000001
10000000000001
10000000000001
10E0000C000001
10000000000001
10000000000001
11111100000001
11111100000001
11111100000001
1111110C000001
111111000P0001
11111111111111