111111
1P0C11
111111
1C00E1
111111