111111
1P0C11
100111
1001E1
111111