1111111111111
1001000000001
1000010000E01
1P00010000001
1111111111111