111111111111111
100000H0000C001
100C0000P0V0001
110111000011111
1E00000C0011111
111111111111111